#############################################################
#...........................................................#
#.######..###################################################
#.#####..####################################################
#.#####...###################################################
#.######...##################################################
#.#######...#################################################
#.########...################################################
#.##########...##############################################
#.############....###########################################
#.##############....#########################################
#.###############....########################################
#.##############.................................############
#.#############.....................................#########
#.#############........................................######
#.#############.........................................#####
#.#############.........................................#####
#.#############........................................######
#.#############......................................########
#.#############.....................................#########
#.##############..................................###########
#.###############....................########################
#.##############....#########################################
#.############....###########################################
#.##########...##############################################
#.########...################################################
#.#######...#################################################
#.######...##################################################
#.#####...###################################################
#.#####..####################################################
#.######..###################################################
#...........................................................#
#############################################################