#############################################################
########..###################################################
#######..####################################################
#######...###################################################
########...##################################################
#########...#################################################
##########...################################################
############...##############################################
##############....###########################################
################....#########################################
#################....########################################
################.................................############
###############.....................................#########
###############........................................######
###############.........................................#####
###############.........................................#####
###############........................................######
###############......................................########
###############.....................................#########
################..................................###########
#################....................########################
################....#########################################
##############....###########################################
############...##############################################
##########...################################################
#########...#################################################
########...##################################################
#######...###################################################
#######..####################################################
########..###################################################
#############################################################